00000000000
01111110110
00000000010
01111110110
01111110110
01111110110
00000001110